11111111111111111111111111111111111111
10000000C00100000000000000000000000001
10C00111110000000000000000000000000001
10010P00C00000000000000000000000000001
10010000111100000000000000000000000001
10001111001100000000000000000000000001
1C011E00000C00000000000000C00000000001
11111111111111111111111111111111111111
